...###
..##.#.####
.##..###..#
##........#
#...@..#..D
###..###..#
..#..#....#
.##.##.#.##
.#......##
.#.....##
.#######